{
  "name": "Classic Maze",
  "level": 1,
  "width": 25,
  "height": 23,
  "tileSize": 20,
  "difficulty": 1,
  "ghostSpeed": 80,
  "playerSpeed": 100,
  "powerPelletDuration": 10000,
  "layout": [
    [1,1,1,1,1,1,1,1,1,1,1,1,1,1,1,1,1,1,1,1,1,1,1,1,1],
    [1,2,2,2,2,2,2,2,2,2,2,2,1,2,2,2,2,2,2,2,2,2,2,2,1],
    [1,3,1,1,1,2,1,1,1,1,1,2,1,2,1,1,1,1,1,2,1,1,1,3,1],
    [1,2,2,2,2,2,2,2,2,2,2,2,2,2,2,2,2,2,2,2,2,2,2,2,1],
    [1,2,1,1,1,2,1,2,1,1,1,1,1,1,1,1,1,2,1,2,1,1,1,2,1],
    [1,2,2,2,2,2,1,2,2,2,2,2,1,2,2,2,2,2,1,2,2,2,2,2,1],
    [1,1,1,1,1,2,1,1,1,1,1,0,1,0,1,1,1,1,1,2,1,1,1,1,1],
    [1,1,1,1,1,2,1,0,0,0,0,0,0,0,0,0,0,0,1,2,1,1,1,1,1],
    [1,1,1,1,1,2,1,0,1,1,0,0,0,0,0,1,1,0,1,2,1,1,1,1,1],
    [0,0,0,0,0,2,0,0,1,0,0,0,0,0,0,0,1,0,0,2,0,0,0,0,0],
    [1,1,1,1,1,2,1,0,1,0,0,0,5,0,0,0,1,0,1,2,1,1,1,1,1],
    [1,1,1,1,1,2,1,0,1,1,1,1,1,1,1,1,1,0,1,2,1,1,1,1,1],
    [1,1,1,1,1,2,1,0,0,0,0,0,0,0,0,0,0,0,1,2,1,1,1,1,1],
    [1,1,1,1,1,2,1,1,1,1,1,0,1,0,1,1,1,1,1,2,1,1,1,1,1],
    [1,2,2,2,2,2,2,2,2,2,2,2,1,2,2,2,2,2,2,2,2,2,2,2,1],
    [1,2,1,1,1,2,1,1,1,1,1,2,1,2,1,1,1,1,1,2,1,1,1,2,1],
    [1,3,2,2,1,2,2,2,2,2,2,2,2,2,2,2,2,2,2,2,1,2,2,3,1],
    [1,1,1,2,1,2,1,2,1,1,1,1,1,1,1,1,1,2,1,2,1,2,1,1,1],
    [1,2,2,2,2,2,1,2,2,2,2,2,1,2,2,2,2,2,1,2,2,2,2,2,1],
    [1,2,1,1,1,1,1,1,1,1,1,2,1,2,1,1,1,1,1,1,1,1,1,2,1],
    [1,2,2,2,2,2,2,2,2,2,2,2,4,2,2,2,2,2,2,2,2,2,2,2,1],
    [1,1,1,1,1,1,1,1,1,1,1,1,1,1,1,1,1,1,1,1,1,1,1,1,1]
  ],
  "legend": {
    "0": "empty",
    "1": "wall", 
    "2": "pellet",
    "3": "powerPellet",
    "4": "playerSpawn",
    "5": "ghostSpawn"
  },
  "specialRules": {
    "tunnels": [
      {"from": {"x": 0, "y": 9}, "to": {"x": 24, "y": 9}}
    ],
    "noGhostZones": [
      {"x": 12, "y": 20, "radius": 3}
    ]
  },
  "bonusItems": [
    {"x": 12, "y": 15, "type": "cherry", "points": 100, "appearTime": 30000},
    {"x": 12, "y": 7, "type": "strawberry", "points": 300, "appearTime": 60000}
  ],
  "description": "The classic maze layout - perfect for learning the game mechanics.",
  "tips": [
    "Stay close to walls when being chased",
    "Use the side tunnels to escape ghosts", 
    "Save power pellets for when you're in danger",
    "Each ghost has different behavior patterns"
  ]
}